111111111111111111110011111111111111
100000000000000000000000000000000001
100000000000000000000000000000000001
100111111111111111111111111111111001
100100000000000000001000000000001001
100100000000000000001000000000001001
100100111111111100111111111111001001
111100100000000000000000000001001001
100100100000000000000000000001001001
100100100111111111111111111001001001
100100100100000000000100001001001001
100100100100000000000100001000001001
100100100000111111111111001000001001
100100100000100000000001001001001001
100100100100100000000001001001001001
100100100100100111111001001001001001
100100100100100100001000001001001001
100111100100000100001000001001001001
100100100100000100001001001001001001
100100100100100110011001001001001001
100000100100100100000001111001001001
100000100100100100000001001001001001
100100100100111111111111001001001001
100100100100000000000000001001001001
100100100100000000000000001001001001
100100100111111111111111111001001001
100100100000000000000000000001001001
100100100000000000000000000001001001
100100111111100111111111111111001001
100100000000000000010000000000001001
100100000000000000010000000000001001
100111111111111111111111110011111001
100000000010000000000000000000000001
100000000010000000000000000000000001
111111111111111111111111111111111111